11111111
10P00001
10I00001
10E00001
11111111
