11111111
10P00001
10C00001
10E00001
11111111
