11111111
111P1111
11101111
1C000C11
111011C1
11000101
1E1C0101
10000001
11111111
