111111111111
110000000001
1E1P00000001
1010000C0001
100000000001
111111111111
