1111111111111111111111111111111
1P00000000000000000000C00100001
1010000000000000001111111100001
1010000000000000000000000000001
1010000000000000000000000000001
1011111000000000000000000000111
1000000000011111111110000000111
1000000000010000000001000000101
110000000001000E000000100000011
1000000000100000000000100000111
1C0010000000111111111100C000011
1101111100010000000000000000111
1C100100001000C0000000000000011
1011011111110000000000000000001
1000000000000011100000000011111
1111111111111111111111111111111
