1111111111111111111111111111111
1P1C0000000000000000C1100000C11
1011100000101000111111100000111
10111110001C1001111111111001111
1000000000111000000000000011111
1111111111111011111111111111111
1000000000000000000111111111111
1110111111111111111111111111111
111011111100000C000000000001111
1000000000000000000000000000111
1C0011111100000000000000C000E11
1111111110000000000000000000111
1C111100000000C0000000000000011
1010000000000000000111111111111
1000000000000011111111111111111
1111111111111111111111111111111
