1111111111111111111111
10000100P00000001E1111
1000000000C00000001111
1111111111111111111111
