11111
11P11
11011
1C0C1
11011
1E001
11111
