1111111111111111111111111111111
1P10000000000000000001100000011
1011100000101000111111100000111
1011111000101001111111111001111
1000000000111000000000000011111
1111111111111011111111111111111
1000000000000000000111111111111
1110111111111111111111111111111
1110111111000000000000000001111
1000000000000000000000000000111
1000111111000000000000000000E11
1111111110000000000000000000111
1C11110000000000000000000000011
1010000000000000000111111111111
1000000000000011111111111111111
1111111111111111111111111111111
